                
      vv        
      vv        
NNNNNNvvNNNNTNNN
NTENNNvvNNNNTEEN
BTENNDvvNNNNTEEN
NNNNNNvvNNNNTNNN
ppppppvvpppppppp
SSSSSSvvSSSSSSSS
SSSSSDvvSSSCSSSS
ASCSSSvvSSSSSSSS
SSSSSSvvSSSSSSSS